1111111111111111111111111111111111
100Z00000000000C0000PC000000000001
1010010100100000101001000000Z10101
1010010100111110001001000E00010101
101111010C00C0000011110000000000C1
1010010100000Z00000000000000110001
1010010100Z00000000001110000110001
10000000000000000000011100000Z0001
1111000001100Z01100001110000000001
100000Z001100001100000000000010001
1000000000000001100000000000010001
1111111111111111111111111111111111
