1111111111111111111111111111111111
100000000000000C0000PC0Z0000000001
1000010100100000101001000000010101
1000010100111010001001000E00010101
101111010C00C0000000000000000000C1
1010010100000000000000000000000001
1010010100000000000000011000000001
100000000010000Z000000011000000001
1000000000100000000000000000000001
1000000000100111100000000Z00000001
1000000000000000000000000000000001
1111111111111111111111111111111111
