1111111111111111111111111111
1E0000000000000C000Z0C000001
1P10010100100000101001000101
1010010C10101010001001000101
100000000C00000000000000Z001
1111111111111111111111111111
