1111111111111111111111111111111111
100Z00000000000C0000PC000000000001
1010010100100000101001000000Z10101
1010010100101010001001000E00010101
101111010C00C0000011100000000000C1
1010010100000Z00000010000000000001
1010010100Z00000000010010000000001
10000000000000000000111100000Z0001
1111000001100Z00000001110000000001
100000Z001100000000000000000000001
1000000000000000000000000000000001
1111111111111111111111111111111111
